[
  ["a", "m", "a", "m", "a", "m", "a", "m", "a", "m", "a", "m", "a", "m", "a", "m", "a", "m", "a", "m", "a"],
  ["a", "a", "a", "a", "a", "a", "a", "a", "a", "a", "a", "a", "a", "a", "a", "a", "a", "a", "a", "a", "a"],
  ["a", "m", "a", "m", "a", "m", "a", "m", "a", "m", "a", "m", "a", "m", "a", "m", "a", "m", "a", "m", "a"],
  ["a", "a", "a", "a", "a", "a", "a", "a", "a", "c", "a", "a", "a", "a", "a", "a", "a", "a", "a", "a", "a"],
  ["a", "m", "a", "m", "a", "m", "a", "m", "w", "m", "w", "m", "a", "m", "a", "m", "a", "m", "a", "m", "a"],
  ["a", "a", "a", "a", "a", "a", "a", "w", "a", "a", "a", "w", "a", "a", "a", "a", "a", "a", "a", "a", "a"],
  ["a", "m", "a", "m", "a", "m", "a", "m", "a", "m", "a", "m", "a", "m", "a", "m", "a", "m", "a", "m", "a"],
  ["a", "a", "a", "a", "a", "a", "a", "w", "bu", "a", "fu", "w", "a", "a", "a", "a", "a", "a", "a", "a", "a"],
  ["a", "m", "a", "m", "a", "m", "a", "m", "w", "m", "w", "m", "a", "m", "a", "m", "a", "m", "a", "m", "a"],
  ["a", "a", "a", "a", "a", "a", "a", "a", "a", "a", "c", "a", "a", "a", "a", "a", "a", "a", "a", "a", "a"],
  ["a", "m", "a", "m", "a", "m", "a", "m", "a", "m", "a", "m", "a", "m", "a", "m", "a", "m", "a", "m", "a"],
  ["a", "a", "a", "a", "a", "a", "a", "a", "a", "a", "a", "a", "a", "a", "a", "a", "a", "a", "a", "a", "a"],
  ["a", "m", "a", "m", "a", "m", "a", "m", "a", "m", "a", "m", "a", "m", "a", "m", "a", "m", "a", "m", "a"],
  ["a", "a", "a", "a", "a", "a", "a", "a", "a", "a", "a", "a", "a", "a", "a", "a", "a", "a", "a", "a", "a"]
]