[
  ["a", "w", "a", "w", "a", "w", "a", "a", "a", "a", "a", "a", "a", "a", "a"],
  ["a", "a", "a", "a", "a", "a", "a", "a", "a", "a", "a", "a", "a", "a", "a"],
  ["a", "a", "a", "a", "a", "w", "a", "a", "a", "a", "a", "a", "a", "a", "a"],
  ["a", "a", "a", "a", "a", "w", "a", "a", "a", "a", "a", "a", "a", "a", "a"],
  ["a", "a", "a", "a", "a", "a", "a", "a", "a", "a", "a", "a", "a", "a", "a"],
  ["a", "a", "a", "a", "a", "a", "a", "a", "a", "a", "a", "a", "a", "a", "a"],
  ["a", "a", "a", "a", "a", "a", "a", "a", "a", "a", "a", "a", "a", "a", "a"],
  ["a", "a", "a", "a", "a", "a", "a", "a", "a", "a", "a", "a", "a", "a", "a"],
  ["a", "a", "a", "a", "a", "a", "a", "a", "a", "a", "a", "a", "a", "a", "a"],
  ["a", "a", "a", "a", "a", "a", "a", "a", "a", "a", "a", "a", "a", "a", "a"]
]