[
  ["a", "w", "a", "w", "a", "w", "a", "a", "a", "a", "a", "a", "a", "a", "a"],
  ["a", "a", "a", "a", "a", "w", "a", "c", "a", "a", "a", "a", "a", "a", "a"],
  ["a", "a", "bu", "a", "a", "w", "a", "a", "a", "a", "a", "a", "a", "w", "a"],
  ["a", "a", "a", "a", "a", "w", "w", "w", "a", "w", "w", "w", "a", "w", "a"],
  ["a", "a", "fu", "a", "a", "a", "a", "a", "a", "a", "a", "w", "a", "w", "a"],
  ["a", "a", "a", "a", "a", "a", "a", "a", "a", "a", "a", "w", "a", "w", "a"],
  ["a", "a", "a", "a", "a", "a", "a", "a", "a", "a", "a", "w", "a", "w", "a"],
  ["a", "a", "a", "a", "c", "a", "a", "a", "a", "a", "a", "a", "a", "w", "a"],
  ["a", "a", "a", "a", "a", "a", "a", "a", "a", "a", "a", "a", "a", "w", "a"],
  ["a", "a", "a", "a", "a", "a", "a", "a", "a", "a", "a", "a", "a", "a", "a"]
]