[
  ["a", "w", "a", "w", "a", "w", "a", "a", "a", "a", "a", "a", "a", "a", "a"],
  ["a", "a", "a", "a", "a", "w", "a", "a", "a", "a", "a", "a", "a", "a", "a"],
  ["a", "a", "a", "a", "a", "w", "a", "a", "a", "a", "a", "a", "a", "w", "a"],
  ["a", "a", "a", "a", "a", "w", "w", "w", "a", "w", "w", "w", "a", "w", "a"],
  ["a", "a", "a", "a", "a", "a", "a", "a", "a", "a", "a", "w", "a", "w", "a"],
  ["a", "a", "a", "a", "a", "a", "a", "a", "a", "a", "a", "w", "a", "w", "a"],
  ["a", "a", "a", "a", "a", "a", "a", "a", "a", "a", "a", "w", "a", "w", "a"],
  ["a", "a", "a", "a", "a", "a", "a", "a", "a", "a", "a", "a", "a", "w", "a"],
  ["a", "a", "a", "a", "a", "a", "a", "a", "a", "a", "a", "a", "a", "w", "a"],
  ["a", "a", "a", "a", "a", "a", "a", "a", "a", "a", "a", "a", "a", "a", "a"]
]